              #####################
              #          $        #
              #     %%%%%%%%%%%%% #
              #     %           % #
              #&   $#           # #
              #######         ### #
                              #$  #
                              #  ##
                              %  # 
                       %%%%%%%%  # 
                       # $$      # 
                       #   ####### 
                    ####   #       
  #######   ######  #    ###       
###     #   #    #  #    ######### 
#       ##### ## ####      $     # 
#   $#        ##   $     $#####  # 
# #######################        # 
#$#                     %$      $# 
###                     %######### 