################################
#                             $#
#                              #
#    %%%                %%%    #
#    %%%                %%%    #
#$             ..              #
###           .  .$          ###
  #         $.    .          #  
  #         .      .         #  
  #        .   ..   .        #  
  #         ...  ...$        #  
  #                         $#  
   #%%%%%%             %%%%%#   
    #   .   .   .  .   .  $#    
    #$  .   .   .  .   .   #    
    #%%%%%%%%%%%%%%%%%%%%%%#    