################################
#                             $#
#                              #
#    %%%      ....      %%%    #
#    %%%      .  .      %%%    #
#$            .  .             #
###           .  .$          ###
  #         $..  ..          #  
  #         .      .         #  
  #        .   ..   .        #  
  #         ...  ...$        #  
  #                         $#  
   #%%%%%%             %%%%%#   
    #   .   .   .  .   .  $#    
    #$  .   .   .  .   .   #    
    #%%%%%%%%%%%%%%%%%%%%%%#    