#%%%%%%%%%%########
#          #      #
#          #      #
#          #      #
#$    &    #$     #
#.  . .    ##     #
#  %       %#     #
#  %              #
#  %$        $    #
#  ################
#   $             #
################# #
#       $         #
# #################
#            $    #
###################