
██╗   ██╗██╗ ██████╗████████╗ ██████╗ ██████╗ ██╗   ██╗
██║   ██║██║██╔════╝╚══██╔══╝██╔═══██╗██╔══██╗╚██╗ ██╔╝
██║   ██║██║██║        ██║   ██║   ██║██████╔╝ ╚████╔╝ 
╚██╗ ██╔╝██║██║        ██║   ██║   ██║██╔══██╗  ╚██╔╝  
 ╚████╔╝ ██║╚██████╗   ██║   ╚██████╔╝██║  ██║   ██║   
  ╚═══╝  ╚═╝ ╚═════╝   ╚═╝    ╚═════╝ ╚═╝  ╚═╝   ╚═╝   